右髋部	身体部位
疼痛	症状和体征
肿胀	症状和体征
鼻部	身体部位
面部	身体部位
痛	症状和体征
腰部	身体部位
头晕	症状和体征
上腹部	身体部位
腰背部	身体部位
胀	症状和体征
侧腹部	身体部位
侧腰部	身体部位
头面部	身体部位
颈部	身体部位
左膝	身体部位
胸闷	症状和体征
右股内侧	身体部位
红肿	症状和体征
左前臂	身体部位
出血	症状和体征
头痛	症状和体征
咳嗽	症状和体征
咳痰	症状和体征
发热	症状和体征
急性支气管炎	疾病和诊断
抽搐	症状和体征
疱疹性咽峡炎	疾病和诊断
热性惊厥	疾病和诊断
右手拇指末节	身体部位
屈曲畸形	症状和体征
腹痛	症状和体征
呕吐	症状和体征
肠系膜淋巴结炎	疾病和诊断
急性上呼吸道感染	疾病和诊断
荨麻疹	疾病和诊断
支气管肺炎	疾病和诊断
皮疹	症状和体征
急性化脓性扁桃体炎	疾病和诊断
肺炎	疾病和诊断
后臀部	身体部位
流涕	症状和体征
喘憋	症状和体征
喘息性-支气管炎	疾病和诊断
尿频	症状和体征
尿痛	症状和体征
泌尿系感染	疾病和诊断
左上肢	身体部位
肿物	症状和体征
左肺肺炎	疾病和诊断
鼻塞	症状和体征
轻咳	症状和体征
急性扁桃体炎	疾病和诊断
喘憋性支气管炎	疾病和诊断
双膝关节	身体部位
畸形	症状和体征
急性喉-支气管炎	疾病和诊断
渗血	症状和体征
疱疹性口腔炎	疾病和诊断
腹胀	症状和体征
左侧面颊部	身体部位
肿大	症状和体征
急性淋巴结炎	疾病和诊断
少痰	症状和体征
头部	身体部位
腹部	身体部位
双下肢	身体部位
支气管炎	疾病和诊断
左侧肢体	身体部位
右侧肢体	身体部位
麻木	症状和体征
无力	症状和体征
腰痛	症状和体征
左下肢	身体部位
心悸	症状和体征
双下肢无力	症状和体征
呼吸困难	症状和体征
左肘关节	身体部位
活动不灵	症状和体征
胸胀	症状和体征
憋气	症状和体征
麻痛	症状和体征
言语不利	症状和体征
右下肢	身体部位
肩颈部	身体部位
左侧肢体无力	症状和体征
腰	身体部位
双髋部	身体部位
颈肩部	身体部位
右上肢	身体部位
左、右上中切牙	身体部位
右上侧切牙	身体部位
松动	症状和体征
触痛	检查和检验
下唇右侧内黏膜	身体部位
挫伤	症状和体征
左前臂内侧皮肤	身体部位
肢体	身体部位
酸痛	症状和体征
酸麻	症状和体征
右腰部	身体部位
右肩部	身体部位
不适	症状和体征
右侧腰部	身体部位
肛门	身体部位
便	身体部位
左下腹	身体部位
盆腔	身体部位
脐带	身体部位
见红	症状和体征
肿痛	症状和体征
右下腹痛	症状和体征
头昏	症状和体征
四肢	身体部位
左肩部	身体部位
耳鸣	症状和体征
尿管结石	疾病和诊断
咯血	症状和体征
意识不清	症状和体征
左侧肩部	身体部位
右手掌	身体部位
破水	症状和体征
左前胸部	身体部位
左侧阴囊	身体部位
胸背部	身体部位
烧灼感	症状和体征
恶心	症状和体征
腹泻	症状和体征
左侧腹股沟	身体部位
头颈部	身体部位
右腰季肋部	身体部位
右膝	身体部位
左臂	身体部位
淤青	症状和体征
直肠癌	疾病和诊断
心慌	症状和体征
流涎	症状和体征
胃脘部	身体部位
心前区	身体部位
后背部	身体部位
左手拇指末节背侧	身体部位
拇指	身体部位
喘息	症状和体征
右胸	身体部位
背部	身体部位
右手中指	身体部位
肩部	身体部位
左膝部	身体部位
右手	身体部位
左胸部	身体部位
双上肢	身体部位
下腹部	身体部位
胀痛	症状和体征
排尿困难	症状和体征
尿	身体部位
膀胱	身体部位
膀胱造瘘口	身体部位
下肢	身体部位
左面部	身体部位
双上臂	身体部位
前胸部	身体部位
胸部	身体部位
下腹	身体部位
下腹痛	症状和体征
排便	症状和体征
排气	症状和体征
龟头	身体部位
包皮	身体部位
瘙痒	症状和体征
左肘部	身体部位
左踝部	身体部位
右侧胸部	身体部位
右手部	身体部位
会阴部	身体部位
右腕	身体部位
右膝部	身体部位
晕	症状和体征
右颧部	身体部位
双膝部	身体部位
髋部	身体部位
二便	身体部位
查体	检查和检验
心肺腹查体	检查和检验
压痛	检查和检验
右足背动脉	身体部位
足趾	身体部位
鼻	身体部位
鼻尖	身体部位
手背	身体部位
右腿	身体部位
左侧胸	身体部位
大小便	身体部位
头颅五官	身体部位
皮肤	身体部位
左侧胸部	身体部位
双肺	身体部位
呼吸音	检查和检验
腹	身体部位
肌紧张	检查和检验
胸部CT	检查和检验
主动脉	检查和检验
左侧胸腔	身体部位
肋骨	身体部位
骨折	症状和体征
双侧瞳孔	身体部位
正大等圆	症状和体征
对光反射	检查和检验
干湿性啰音	检查和检验
心率	检查和检验
律齐	症状和体征
各瓣膜听诊区	身体部位
杂音	检查和检验
反跳痛	检查和检验
包块	症状和体征
叩鼓音	检查和检验
移动性浊音	检查和检验
肠鸣音	检查和检验
肩肘带	身体部位
右颞部	身体部位
右肘部	身体部位
头颅	身体部位
双眼	身体部位
心	身体部位
肺	身体部位
右肩	身体部位
右肘	身体部位
右臀部	身体部位
右肘关节	身体部位
右髋关节	身体部位
头顶部	身体部位
啰音	检查和检验
病理性杂音	检查和检验
全腹	身体部位
左大腿	身体部位
水肿	症状和体征
左小腿	身体部位
左足	身体部位
膝	身体部位
踝关节	身体部位
触压痛	检查和检验
双侧肱二、三头肌反射	检查和检验
膝腱反射	检查和检验
巴彬斯基氏征	检查和检验
克尼格氏征	检查和检验
左侧上腹部	身体部位
结膜	身体部位
苍白	症状和体征
黄染	症状和体征
双侧肋脊角	身体部位
对称	症状和体征
隆起	症状和体征
双肾区	身体部位
叩击痛	检查和检验
肿块	症状和体征
耻骨上膀胱区	身体部位
阴茎	身体部位
尿道外口	身体部位
狭窄	症状和体征
阴囊	身体部位
双侧睾丸	身体部位
双侧附睾	身体部位
结节	症状和体征
左背部	身体部位
干燥	症状和体征
渗出	症状和体征
尿液	身体部位
体温	检查和检验
血压	身体部位
脉搏	检查和检验
呼吸	检查和检验
巩膜	身体部位
肝	身体部位
脾	身体部位
右肾区	身体部位
左肾区	身体部位
T	检查和检验
右眼	身体部位
鼻面部	身体部位
颈背部	身体部位
右手环小指	身体部位
右眼部	身体部位
右面皮下	身体部位
血肿	症状和体征
颈部后侧	身体部位
右手小指	身体部位
侧附睾	身体部位
双侧肾区	身体部位
双侧阴囊	身体部位
附睾	身体部位
肩关节	身体部位
左肘	身体部位
左侧腰部肌肉组织	身体部位
腰椎	身体部位
左膝关节组织	身体部位
余肢体	身体部位
气管	身体部位
胸廓	身体部位
呼吸动度	检查和检验
皮下捻发音	检查和检验
叩音	检查和检验
腹壁	身体部位
静脉曲张	症状和体征
双侧肱二三头肌	身体部位
双侧Babinski征	检查和检验
克氏症	检查和检验
左股	身体部位
光反射	检查和检验
左手指	身体部位
右小腿	身体部位
痰	身体部位
口唇	身体部位
发绀	症状和体征
咽部	身体部位
充血	症状和体征
咽峡部	身体部位
疱疹	症状和体征
扁桃体	身体部位
脓苔	症状和体征
清音	检查和检验
胸膜	身体部位
摩擦音	检查和检验
鼓音	检查和检验
浮肿	症状和体征
胸片	检查和检验
两肺	身体部位
血常规	检查和检验
白细胞数	检查和检验
中性粒细胞百分比	检查和检验
淋巴细胞	检查和检验
红细胞数	检查和检验
血小板数	检查和检验
小便	身体部位
大便	身体部位
舌体	身体部位
溃疡	症状和体征
白细胞	检查和检验
中性细胞比率	检查和检验
淋巴细胞数	检查和检验
红细胞	检查和检验
血红蛋白	检查和检验
血小板	检查和检验
C-反应蛋白	检查和检验
右手拇指	身体部位
口腔黏膜	身体部位
双扁桃体	身体部位
咽后壁	身体部位
脐周	身体部位
腹部彩超	检查和检验
腹部脐周大血管	身体部位
肠系膜	身体部位
嗜酸粒细胞	检查和检验
单核细胞绝对值	检查和检验
中性细胞数	检查和检验
心尖部	身体部位
神经系统	身体部位
胸部正位片	检查和检验
淋巴细胞百分比	检查和检验
中性粒细胞绝对值	检查和检验
淋巴细胞绝对值	检查和检验
呼吸道病原体联合检测	检查和检验
肺炎支原体IgM抗体	检查和检验
肺炎衣原体IgM抗体	检查和检验
呼吸道合胞病毒IgM抗体	检查和检验
腺病毒IgM抗体	检查和检验
柯萨奇病毒B组IgM抗体	检查和检验
微量元素测定	检查和检验
铜	检查和检验
锌	检查和检验
钙	检查和检验
镁	检查和检验
铁	检查和检验
胸肺腹	身体部位
臀部	身体部位
骨盆	身体部位
挤压试验	检查和检验
骨盆正位片	检查和检验
尺骨支	身体部位
坐骨支	身体部位
尿常规	检查和检验
尿红细胞	检查和检验
尿白细胞	检查和检验
白细胞团	检查和检验
酮体-	检查和检验
潜血-	检查和检验
亚硝酸盐-	检查和检验
白细胞-	检查和检验
皮缘	身体部位
湿性啰音	检查和检验
全身浅表淋巴节	身体部位
双扁桃	身体部位
咽	身体部位
便常规	检查和检验
两下肺	身体部位
胸	身体部位
心脏听诊	检查和检验
左膝关节	身体部位
右膝关节	身体部位
双踝关节	身体部位
足背动脉	身体部位
粘液丝	检查和检验
比重	检查和检验
右肺	身体部位
左肺	身体部位
脐	身体部位
周身皮肤	身体部位
肝、脾肋下	身体部位
上颚	身体部位
心肌酶	检查和检验
肌酸激酶	检查和检验
肌酸激酶同工酶	检查和检验
乳酸脱氢酶	检查和检验
羟丁酸脱氢酶	检查和检验
单核细胞百分比	检查和检验
两下肺肺纹理	身体部位
支气管	身体部位
淋巴节	身体部位
躯干	身体部位
右眼结膜	身体部位
右侧颜面部	身体部位
下颌部	身体部位
头颅枕顶部	身体部位
头皮	身体部位
右侧眼睑	身体部位
双眼瞳孔	身体部位
右侧面颧部	身体部位
右侧下颌淋巴结	身体部位
右侧肘部	身体部位
肌力	检查和检验
肌张力	检查和检验
面颊部	身体部位
双侧舌下淋巴结	身体部位
双侧牙龈	身体部位
双侧第一乳磨牙	身体部位
左上乳中切牙	身体部位
痰鸣音	检查和检验
右下肺	身体部位
双侧大腿	身体部位
眼眶	身体部位
胃肠道常规彩超	检查和检验
Bp	检查和检验
肺腹	身体部位
左侧上下肢	身体部位
双侧巴氏征	检查和检验
寒战	症状和体征
神经系统查体	检查和检验
右侧上下肢	身体部位
生理反射	检查和检验
病理反射	检查和检验
BP	检查和检验
神经系统检查	检查和检验
额	身体部位
瞳孔	身体部位
唇	身体部位
舌	身体部位
双侧肱二，三头肌腱	身体部位
跟膝腱反射	检查和检验
克氏征	检查和检验
干啰音	检查和检验
湿啰音	检查和检验
咽痛	症状和体征
肘部	身体部位
腕部	身体部位
气短	症状和体征
瓣膜	身体部位
肌腱	身体部位
L4-S1椎体棘突两侧	身体部位
直腿抬高试验	检查和检验
拾物试验	检查和检验
4字试验	检查和检验
左上下肢	身体部位
双侧语颤	检查和检验
相对浊音界	检查和检验
右侧锁骨中线第5肋间	身体部位
右肺下野	身体部位
胸痛	症状和体征
肋下	身体部位
心肺腹听诊	检查和检验
血糖	检查和检验
血脂	检查和检验
L3-S1椎体棘突旁	身体部位
四字试验	检查和检验
腰椎椎体棘突两侧	身体部位
放射痛	检查和检验
颈	身体部位
12 42牙齿	身体部位
前臂	身体部位
口腔内黏膜	身体部位
改善脑血管及调整血压变化药物	治疗
颈椎椎体棘突	身体部位
扣顶试验	检查和检验
曲颈试验	检查和检验
牵拉试验	检查和检验
前列腺	身体部位
颈椎病	疾病和诊断
腰椎椎体棘突	身体部位
各瓣膜	身体部位
上下肢	身体部位
甲状腺	身体部位
CT检查	检查和检验
胆囊	身体部位
右肾	身体部位
中值细胞	检查和检验
臂丛神经牵拉	身体部位
L4-S1椎体棘突	身体部位
身痛逐瘀汤	治疗
改善脑血管药物	治疗
两侧阴囊	身体部位
臂丛神经	身体部位
肩	身体部位
降血脂及改善心肌供血药物	治疗
P	检查和检验
R	检查和检验
膨隆	症状和体征
全腹部	身体部位
干性啰音	检查和检验
右上腹	身体部位
莫非氏征	检查和检验
阴道	身体部位
子宫	身体部位
宫底脐下	身体部位
外阴	身体部位
头	身体部位
右颧面部	身体部位
右手腕部	身体部位
右胸部	身体部位
左小腿皮肤	身体部位
周围皮肤	身体部位
双侧鼻唇沟	身体部位
齿口角	身体部位
双侧肱二三头肌腱及跟膝腱反射	检查和检验
左肩	身体部位
鼻唇沟	身体部位
双侧肱二、三头肌腱反射	检查和检验
Kerning征	检查和检验
右膝部外侧	身体部位
右足趾	身体部位
双侧肱二三头肌腱反射	检查和检验
双侧跟膝腱反射	检查和检验
双侧巴氏症	检查和检验
L4-S1棘突左侧	身体部位
头颅额部鼻背部	身体部位
双侧肱二，三头 肌腱	身体部位
双侧输尿管	身体部位
两侧阴囊、睾丸	身体部位
颜面部	身体部位
颈后部	身体部位
白痰	身体部位
左侧耳	身体部位
右侧腰3-4椎旁	身体部位
肿	症状和体征
五官	身体部位
晨查	检查和检验
双乳	身体部位
外阴侧切口	身体部位
左眼	身体部位
右侧阴囊	身体部位
双侧睾丸附睾	身体部位
前列腺指诊	检查和检验
脊柱	身体部位
左胸背部	身体部位
眼睑	身体部位
睑结膜	身体部位
外耳道	身体部位
双侧扁桃腺	身体部位
静脉	身体部位
怒张	症状和体征
颈动脉	身体部位
异常搏动	症状和体征
胃肠	身体部位
双侧肱二	身体部位
三头肌	身体部位
左侧胸背部	身体部位
左手	身体部位
左肩关节	身体部位
左腕	身体部位
各手指关节	身体部位
左颈部	身体部位
皮下	身体部位
瘀斑	症状和体征
左足趾	身体部位
左小腿外侧	身体部位
左足踇趾	身体部位
足背部	身体部位
腿	身体部位
各足趾关节	身体部位
肌	身体部位
足背伸力	检查和检验
末梢	身体部位
右下腹	身体部位
肝区	身体部位
阑尾炎	疾病和诊断
碘伏	治疗
双侧肢体	身体部位
粘膜	身体部位
淋巴结	身体部位
等大等圆	症状和体征
对光反应	检查和检验
腰椎棘突	身体部位
肱二、三肌腱反射	检查和检验
病理反射征	检查和检验
腰1-5椎体	身体部位
肝肺	身体部位
右锁骨中线第Ⅵ肋	身体部位
右侧输尿管	身体部位
肢	身体部位
反酸	症状和体征
烧心	症状和体征
腰3-5椎棘突间隙	身体部位
腰部双侧竖脊肌	身体部位
腰方肌	身体部位
左手拇指	身体部位
左手拇指外侧	身体部位
关节	身体部位
枕部上方	身体部位
双面部	身体部位
左前胸局部	身体部位
上腹部软组织	身体部位
左髋部	身体部位
双膝部内侧	身体部位
颈静脉	身体部位
干湿啰音	检查和检验
心、肺	身体部位
造瘘口	身体部位
造瘘肠管	身体部位
手术切口皮缘	身体部位
右胸背部双下肢	身体部位
各椎体棘突	身体部位
脊肋角	身体部位
肛门外	身体部位
各关节	身体部位
右腹股沟部	身体部位
睾丸附睾	身体部位
睾丸	身体部位
透光试验	检查和检验
右中指	身体部位
右手中指末节	身体部位
指骨末端	身体部位
四肢皮肤	身体部位
各足趾	身体部位
左侧臀部	身体部位
直腿抬高实验	检查和检验
双下肢皮肤	身体部位
双足趾	身体部位
背伸力	检查和检验
前额	身体部位
左侧下眼睑	身体部位
右侧胸锁乳肌	身体部位
双膝	身体部位
左眉弓	身体部位
裂伤	症状和体征
左耳	身体部位
锁骨	身体部位
腰部以下	身体部位
彩超	检查和检验
膀胱壁	身体部位
红细胞压积	检查和检验
平均血小板体积	检查和检验
尿蛋白	检查和检验
肝功能	检查和检验
谷草转氨酶	检查和检验
-谷氨酰转肽酶	检查和检验
右腹部	身体部位
左腹部	身体部位
肾上腺CT	检查和检验
左侧肾上腺	身体部位
肾上腺腺瘤	疾病和诊断
左手环指	身体部位
各掌指关节	身体部位
检查	检查和检验
裂开	症状和体征
尿道	身体部位
分泌物	检查和检验
左前胸第四、五肋部	身体部位
表面皮肤	身体部位
叩清音	检查和检验
心腹	身体部位
双侧输尿管走行区	身体部位
骶尾部	身体部位
破溃	症状和体征
椎旁	身体部位
踇趾	身体部位
左肾	身体部位
CT双肾	检查和检验
抗生素	治疗
双上臂内侧	身体部位
胸骨中上段	身体部位
右侧锁骨中线第Ⅴ肋	身体部位
胸椎中上段	身体部位
腰部局部	身体部位
左胸肋部	身体部位
左胸肋部局部	身体部位
右踝内侧	身体部位
肝脾胃	身体部位
阑尾	身体部位
触觉语颤	检查和检验
右锁骨中线第Ⅵ肋间	身体部位
心包	身体部位
直肠指诊	检查和检验
尿道外	身体部位
胃管	身体部位
胃液	身体部位
周身皮肤黏膜	身体部位
出血点	身体部位
周身浅表淋巴	身体部位
血氧饱和度	检查和检验
周身浅表淋巴结	身体部位
耳鼻	身体部位
右侧锁骨中线第Ⅴ肋间	身体部位
各椎体	身体部位
四肢关节	身体部位
右侧侧臀部	身体部位
右侧膝盖	身体部位
右踝部	身体部位
左膝下方	身体部位
左踝	身体部位
脓	身体部位
血	身体部位
口服抗生素	治疗
左上臂近肘关节处	身体部位
前胸部局部软组织	身体部位
心脏	身体部位
头顶部右侧	身体部位
手指	身体部位
肺心腹	身体部位
左下颌皮肤	身体部位
右腹股沟	身体部位
右侧胸壁腋前线	身体部位
胸壁局部软组织	身体部位
上唇	身体部位
鼻背部	身体部位
右上唇	身体部位
右手内侧	身体部位
双侧腹股沟	身体部位
双瞳孔	身体部位
瓣膜区	身体部位
谵妄	症状和体征
头左颞部	身体部位
左颧弓处	身体部位
左眼眶	身体部位
右前额	身体部位
右耳	身体部位
右颧部皮肤	身体部位
右耳廓	身体部位
右上胸部	身体部位
右季肋部	身体部位
右背部	身体部位
左侧头颞部皮肤	身体部位
左手第4、5掌指关节背侧皮肤	身体部位
右肩关节	身体部位
头右顶枕部	身体部位
耳	身体部位
喉腔	身体部位
扁桃腺	身体部位
左髋部X光片	检查和检验
左侧粗隆间	身体部位
左侧粗隆间骨折	疾病和诊断
短缩畸形	症状和体征
外旋内收畸形	症状和体征
右髋关节正位片	检查和检验
右侧股骨粗隆间	身体部位
脑梗死	疾病和诊断
高血压	疾病和诊断
肝炎	疾病和诊断
结核病	疾病和诊断
心脏病	疾病和诊断
头颅和鼻骨，肝胆脾胰CT	检查和检验
鼻骨	身体部位
双侧额突	身体部位
双侧筛窦	身体部位
上颌窦黏膜	身体部位
鼻中隔	身体部位
双侧基底节区	身体部位
腔隙性脑梗死	疾病和诊断
肝胆脾胰	身体部位
面部外伤	疾病和诊断
鼻骨骨折	疾病和诊断
鼻梁皮肤	身体部位
鼻腔	身体部位
口内上唇黏膜	身体部位
两眉之间	身体部位
头颅、鼻骨、肝胆脾胰CT	检查和检验
右胫骨	身体部位
手术治疗（具体不详）	治疗
糖尿病	疾病和诊断
胰岛素	治疗
左面侧额部	身体部位
拍片	检查和检验
左侧肋骨骨折	疾病和诊断
全身皮肤粘膜	身体部位
斑丘疹	症状和体征
浅表淋巴结	身体部位
压痛点	身体部位
静脉怒张	症状和体征
震颤	症状和体征
叩心界	检查和检验
肋骨重建	检查和检验
右肺中叶炎症	疾病和诊断
纵膈淋巴结	身体部位
主动脉硬化	疾病和诊断
左侧第2、3、4肋骨骨折	疾病和诊断
DR	检查和检验
头颅CT	检查和检验
多处软组织损伤	疾病和诊断
外伤后神经反应	疾病和诊断
右手中指植皮手术	治疗
身体多处	身体部位
左眉弓上皮肤	身体部位
CT	检查和检验
肝胆脾胰双肾CT扫描	检查和检验
头外伤后神经反应	疾病和诊断
跟膝腱	身体部位
双眼周围	身体部位
全腹CT	检查和检验
颈椎、腰椎正侧位	检查和检验
股骨	身体部位
软组织	身体部位
局部软组织	身体部位
后腰部	身体部位
规律服药（具体药名剂量不详）	治疗
鼻甲	身体部位
各鼻窦	身体部位
扣音	检查和检验
外生殖器	身体部位
头、胸CT	检查和检验
腹部CT	检查和检验
左肾结石	疾病和诊断
氨氯地平	治疗
头孢类药物	治疗
左腰部	身体部位
尿潜血	检查和检验
左侧输尿管结石	疾病和诊断
上端输尿管	身体部位
肾盂	身体部位
精神分裂症	疾病和诊断
氯氮平	治疗
超声	检查和检验
右侧输尿管结石	疾病和诊断
右肾结石	疾病和诊断
右肾囊肿	疾病和诊断
氨酚待因	治疗
上段输尿管	身体部位
鼻骨CT	检查和检验
鼻骨右支	身体部位
颧弓CT	检查和检验
右侧眼眶眶内壁	身体部位
右侧眼眶眶内壁骨折	疾病和诊断
右侧鼻翼	身体部位
鼻小柱上皮肤	身体部位
右大腿皮肤	身体部位
钝痛	症状和体征
左侧急性附睾炎	疾病和诊断
左侧附睾	身体部位
右侧附睾	身体部位
鼻窦	身体部位
血管	身体部位
双侧精索	身体部位
注射胰岛素	治疗
左肱骨	身体部位
左侧腰部	身体部位
肘关节	身体部位
左侧气胸	疾病和诊断
左肩皮肤裂伤	疾病和诊断
CT片	检查和检验
右股	身体部位
右侧大腿脂肪层	身体部位
外用药物	治疗
右股内侧蜂窝织炎	疾病和诊断
锐痛	症状和体征
昏迷	症状和体征
多处皮肤软组织裂伤	疾病和诊断
头右侧额部	身体部位
右眼下睑	身体部位
左侧前臂	身体部位
左腕左手指	身体部位
左尺桡动脉	身体部位
左侧膝	身体部位
右侧小腿	身体部位
足背	身体部位
W	检查和检验
皮肤黏膜	身体部位
双眼睑	身体部位
手足	身体部位
中性细胞	检查和检验
全身皮肤黏膜	身体部位
心尖	身体部位
双侧膝	身体部位
跟腱	身体部位
角膜	身体部位
淋巴细胞比率	检查和检验
掌指关节	身体部位
狭窄性剑鞘炎	疾病和诊断
右手掌指关节	身体部位
皮肤、粘膜	身体部位
耳、鼻、喉腔	身体部位
左第五肋间锁骨中线	身体部位
肛门外生殖	身体部位
肱二、三头肌腱	身体部位
盆骨DR	检查和检验
腹部常规彩超	检查和检验
皮髓质	身体部位
咽峡	身体部位
双肺底部	身体部位
面色	身体部位
舌下淋巴结	身体部位
颈软	身体部位
肺纹理	身体部位
肺门	身体部位
干、湿性啰音	检查和检验
两肺纹理	身体部位
全身皮肤	身体部位
神经	身体部位
全身浅表淋巴结	身体部位
双下肺炎症	疾病和诊断
双侧扁桃体	身体部位
手足心	身体部位
中性粒细胞	检查和检验
肺部胸片	检查和检验
双肺纹理	身体部位
发烧	症状和体征
急性支气管	疾病和诊断
感染性喉炎	疾病和诊断
喘息性支气管炎	疾病和诊断
右侧臀部	身体部位
右侧坐骨	身体部位
右侧耻骨	身体部位
骨盆骨折	疾病和诊断
胸壁静脉	身体部位
嗜碱粒细胞百分比	检查和检验
尿胆原	身体部位
两肺支气管	身体部位
肺底部	身体部位
右下肺炎症	疾病和诊断
涕	身体部位
右肺门区	身体部位
左肺门	身体部位
X线检查	检查和检验
颅脑	身体部位
平均血红蛋白量	检查和检验
左下肺	身体部位
双侧膈面	身体部位
左上臂	身体部位
指腹	身体部位
脂肪瘤	疾病和诊断
左上肢肿物彩超	检查和检验
左上肢近端	身体部位
左下肺肺纹理	身体部位
呼吸道病毒联合检测	检查和检验
肺纹理间隙	身体部位
两肺门	身体部位
气管纵膈	身体部位
印象支气管肺炎	疾病和诊断
舌下	身体部位
颈部淋巴结	身体部位
心界	身体部位
脐周大血管	身体部位
右下腹肠管	身体部位
双侧肺	身体部位
药物	治疗
膝关节	身体部位
双膝关节骨性关节炎	疾病和诊断
双膝关节皮肤	身体部位
内外翻试验	检查和检验
前后抽屉试验	检查和检验
双膝X光片	检查和检验
右侧第8肋骨	身体部位
阿奇霉素	治疗
腹部脐周大血管周边	身体部位
两肺中下野	身体部位
干鸣音	检查和检验
左肺上野	身体部位
脐周大血管旁	身体部位
冠心病	疾病和诊断
头颈胸部	身体部位
右上肢及右膝	身体部位
颈胸部	身体部位
下口唇皮肤	身体部位
右膝外侧	身体部位
胸部后前位片	检查和检验
两肺支气管肺炎	疾病和诊断
左侧肺下野心缘	身体部位
血尿常规	检查和检验
右下腹阑尾区	身体部位
右下腹部髂血管	身体部位
肠梗阻	疾病和诊断
右锁骨中线第Ⅴ肋	身体部位
传染病	疾病和诊断
卵巢囊肿手术	治疗
胸部及腹部CT	检查和检验
右肘关节DR片	检查和检验
头皮血肿	疾病和诊断
右侧枕顶部	身体部位
右侧肘后	身体部位
胸部、腹部CT	检查和检验
右肘部DR片	检查和检验
沿肺纹理	身体部位
余两肺	身体部位
牙龈	身体部位
双下肺	身体部位
肺炎支原体	检查和检验
肺炎衣原体	检查和检验
呼吸道合胞病毒	检查和检验
腺病毒	检查和检验
柯萨奇病毒B组	检查和检验
头部、腹部	身体部位
双侧下肢	身体部位
额顶部	身体部位
右侧大腿前外侧	身体部位
左侧大腿	身体部位
降压药物	治疗
耳聋	症状和体征
头颅核磁检查	检查和检验
脑	身体部位
头颅核磁	检查和检验
右侧半卵圆中心	身体部位
心电图	检查和检验
麻木无力	症状和体征
右侧半卵圆中心脑梗死	疾病和诊断
腰椎CT	检查和检验
L3-S1椎间盘CT	检查和检验
椎体边缘骨质	身体部位
腰4-5、腰5-骶1椎间盘	身体部位
椎体边缘	身体部位
硬膜囊	身体部位
额纹	身体部位
肱二，三头 肌腱	身体部位
静点药物	治疗
丙型肝炎	疾病和诊断
保肝药物	治疗
左桡骨远端骨折切开复位内固定术	治疗
左侧股骨骨折切开复位内固定术	治疗
左侧尺桡骨远端	身体部位
左侧股骨	身体部位
左肘关节正侧位	检查和检验
左肘关节骨化性肌炎	疾病和诊断
左尺桡骨正侧位	检查和检验
左桡骨	身体部位
左侧股骨正侧位	检查和检验
左股骨	身体部位
肛门外生殖器	身体部位
左肘关节背	身体部位
左侧腕关节	身体部位
其余肢体	身体部位
脑出血症	疾病和诊断
慢性胃炎	疾病和诊断
硝苯地平缓释片	治疗
双侧肱二，三头肌腱反射	检查和检验
胸肋部	身体部位
肺癌	疾病和诊断
肺内	身体部位
腰4-腰5、腰5-骶1椎间盘	身体部位
左肺下野	身体部位
双侧胸膜	身体部位
双侧胸腔	身体部位
右肺下叶	身体部位
左侧部分肋骨	身体部位
肝右叶	身体部位
房室	身体部位
腰椎间盘CT	检查和检验
L3-5椎间盘	身体部位
椎体	身体部位
膨大	症状和体征
L5-S1椎间盘	身体部位
椎管	身体部位
神经根	身体部位
椎小关节	身体部位
腰椎管	身体部位
椎间孔	身体部位
侧隐窝	身体部位
腰间盘CT	检查和检验
L3-L5椎间盘	身体部位
腰椎间盘突出症	疾病和诊断
L3-L5椎体棘突	身体部位
腰3-骶1椎间盘CT	检查和检验
腰3-腰5椎间盘	身体部位
平痛新	治疗
急性胰腺炎	疾病和诊断
胰腺囊肿	疾病和诊断
胰腺	身体部位
肝内胆管	身体部位
胆总管	身体部位
胆囊窝区	身体部位
腹腔	身体部位
二遍	身体部位
头皮裂伤	疾病和诊断
右侧顶部	身体部位
右侧顶骨	身体部位
并颅内	身体部位
右侧顶部头下	身体部位
L4/5椎间隙水平椎体边缘	身体部位
L5/S1椎间隙水平椎体后缘	身体部位
L3-5椎体骨质边缘	身体部位
L4/5椎间隙	身体部位
L5/S1椎间隙	身体部位
L3-5椎体	身体部位
颈椎CR	检查和检验
C4-C7棘突两侧	身体部位
双侧椎间孔	身体部位
右侧臂丛	身体部位
左侧臂	身体部位
颈椎	身体部位
4-7椎间隙	身体部位
椎体前缘	身体部位
颈部软组织	身体部位
心律失常	疾病和诊断
房颤	疾病和诊断
右侧颞枕部	身体部位
腰椎磁共振平扫	检查和检验
腰2-3、腰5骶1间盘	身体部位
腰3-4、4-5间盘	身体部位
腰4-5间隙	身体部位
L3-L5,L5-骶1椎体棘突旁	身体部位
颈椎X光片	检查和检验
颈椎退行性变	疾病和诊断
双侧臂丛	身体部位
颈椎侧位片	检查和检验
颈椎4-7椎体	身体部位
余椎体及各附件	身体部位
各椎间隙	身体部位
L4-5椎间隙水平椎体边缘及右后缘	身体部位
L5-S1椎间隙水平椎体后缘	身体部位
S1椎板	身体部位
腰4/5椎间隙	身体部位
腰5/骶1椎间隙	身体部位
腰4椎体骨质边缘	身体部位
颈椎DR	检查和检验
颈4、5椎体前缘	身体部位
颈椎椎体棘突旁	身体部位
牙齿	身体部位
腰5-骶1椎间盘	身体部位
颈椎侧双斜位片	检查和检验
颈椎侧、双斜位片	检查和检验
颈椎6-7椎体缘	身体部位
余椎体	身体部位
第4、5颈椎棘突后	身体部位
类风湿性关节炎	疾病和诊断
颈复康	治疗
C4-7椎体骨质边缘	身体部位
C4/C5/6/C6/7椎间隙椎间隙	身体部位
C4/5、C5/6右侧	身体部位
C3/4、C4/5、C5/6、C6/7左侧椎间孔	身体部位
C6/7椎间隙水平椎体前缘	身体部位
硬膜囊前缘	身体部位
双侧侧隐窝	身体部位
部分椎体边缘	身体部位
部分椎小关节突	身体部位
部分椎小关节间隙	身体部位
腰4-骶1椎间盘	身体部位
腰4-5右侧神经根	身体部位
颈椎CT	检查和检验
颈4-6椎间盘	身体部位
叩顶试验	检查和检验
心脑血管疾病	疾病和诊断
L5-S1椎体	身体部位
椎间隙	身体部位
L3-4椎间盘	身体部位
L4-5、L5-S1椎间盘	身体部位
部分椎小关节	身体部位
所示椎体边缘	身体部位
相应水平硬膜囊	身体部位
L3-S1椎间盘	身体部位
L3-S1椎体棘突两侧	身体部位
扑热息痛	治疗
WBC	检查和检验
GR	检查和检验
急性胆囊炎	疾病和诊断
腰椎间盘突出	疾病和诊断
右膝关节置换术	治疗
部分椎体骨质边缘	身体部位
C5/6/C6/7椎间隙水平椎体后缘	身体部位
C5/6/C6/7椎间隙	身体部位
L3-S1椎间盘CT平扫	检查和检验
周围软组织	身体部位
L4-L5椎间盘	身体部位
L3-S1椎体棘突	身体部位
前列腺炎	疾病和诊断
L4-S1椎间盘	身体部位
L5-S1椎体棘突旁	身体部位
颈、腰椎核磁	检查和检验
C2-T2椎间盘	身体部位
L2-S1椎间盘	身体部位
C6-7水平脊髓	身体部位
椎体脂肪	身体部位
L4-S1椎体	身体部位
颈肩	身体部位
脑梗死病	疾病和诊断
颈部血管彩超	检查和检验
左侧臂丛	身体部位
会阴	身体部位
肛门指诊	检查和检验
肛门外括约肌	身体部位
颈椎核磁	检查和检验
C3-7椎间盘	身体部位
C5-6钩椎关节	身体部位
脑桥	身体部位
腰3-骶1椎间盘	身体部位
腰4-5左侧神经根	身体部位
腰3-4、4-5椎间盘	身体部位
慢性咽炎	疾病和诊断
颈椎综合症	疾病和诊断
C4-C7棘突	身体部位
颈椎4-6椎体	身体部位
相应椎间隙	身体部位
椎孔	身体部位
颈2椎体	身体部位
左肾多发结石	疾病和诊断
腰3-腰4椎间盘	身体部位
颈椎侧、双斜位DR片	检查和检验
颈椎4-6椎体缘	身体部位
第6颈椎后缘	身体部位
颈椎5/6椎间隙	身体部位
L4-S1棘突	身体部位
L4-s1椎间盘	身体部位
腰椎骨	身体部位
C4-C6棘突	身体部位
右侧椎间孔	身体部位
颈4、5和5、6椎间隙	身体部位
颈5、6椎间隙	身体部位
颈5后软组织内	身体部位
阑尾切除术	治疗
胃药	治疗
右侧输尿管上端结石	疾病和诊断
肾积水	疾病和诊断
消化性溃疡	疾病和诊断
青光眼	疾病和诊断
腰3/4、腰4/5、腰5/骶1椎间盘	身体部位
腰5/骶1水平椎管	身体部位
胃	身体部位
石蜡油	治疗
腹平片	检查和检验
直肠癌麦氏术	治疗
胃癌	疾病和诊断
慢性阻塞性肺疾病	疾病和诊断
脑梗塞	疾病和诊断
血淀粉酶	检查和检验
上腹部CT	检查和检验
MRCP检查	检查和检验
胆囊结石	疾病和诊断
谷氨酰转肽酶	检查和检验
总胆红素	检查和检验
直接胆红素	检查和检验
泌尿系超声	检查和检验
双肾	身体部位
肝胆胰脾超声	检查和检验
胰	身体部位
腹膜炎	疾病和诊断
左侧附件、右侧附件区	身体部位
妇炎康	治疗
B超	检查和检验
宫颈	身体部位
子宫体	身体部位
子宫体偏左侧	身体部位
剖宫产	治疗
宫高	检查和检验
腹围	检查和检验
胎位	检查和检验
胎心	检查和检验
肛查	检查和检验
宫口	身体部位
胎膜	身体部位
骨盆外	身体部位
髂前上棘间径	检查和检验
髂脊间径	检查和检验
骶耻外径	检查和检验
骨盆出口横径	检查和检验
耻骨弓	检查和检验
羊水指数	检查和检验
左膝关节正侧位片	检查和检验
左膝关节软组织损伤	疾病和诊断
Ｔ	检查和检验
Ｐ	检查和检验
Ｒ	检查和检验
ＢＰ	检查和检验
左膝髌前	身体部位
左侧髌骨外上缘	身体部位
急性阑尾炎	疾病和诊断
阑尾彩超	检查和检验
wbc	检查和检验
进行阑尾炎	疾病和诊断
头额部	身体部位
等大正圆	症状和体征
左侧输尿管再植术	治疗
左输尿管上段	身体部位
X线	检查和检验
左肾结石合并积水	疾病和诊断
双侧沿输尿管	身体部位
肋骨三维重建	检查和检验
胫腓骨DR片	检查和检验
右侧第四肋骨骨皮质	身体部位
右侧第四肋骨骨折	疾病和诊断
身体多处软组织损伤	疾病和诊断
胸部右侧第4肋	身体部位
左侧小腿	身体部位
胫腓骨正侧位	检查和检验
右侧第四肋骨	身体部位
慢性糜烂性胃炎	疾病和诊断
结肠息肉病	疾病和诊断
风湿性关节炎	疾病和诊断
非洛地平缓释片	治疗
含服硝苯地平片	治疗
腔隙性脑梗塞	疾病和诊断
肝脾肋	身体部位
右侧额颞部硬膜下	身体部位
左侧顶部皮下	身体部位
左肩正位片	检查和检验
左锁骨远端	身体部位
胸部DR	检查和检验
右侧额颞部硬膜下血肿	疾病和诊断
右侧顶骨骨折	疾病和诊断
左侧顶部皮下血肿	疾病和诊断
左锁骨远端骨折	疾病和诊断
左肩峰撕脱骨折	疾病和诊断
左侧顶部	身体部位
口角	身体部位
胸壁	身体部位
脑出血病	疾病和诊断
血压值	检查和检验
颜面	身体部位
非洛地平	治疗
替米沙坦	治疗
鼻唇	身体部位
X光片	检查和检验
右下肢软组织损伤	疾病和诊断
双臀部	身体部位
双侧髋部	身体部位
左侧髋关节	身体部位
右侧髋关节	身体部位
右大腿	身体部位
右膝、右踝关节	身体部位
骨盆平片	检查和检验
右膝关节、右胫腓骨X光片	检查和检验
头孢	治疗
消炎药	治疗
止咳、化痰、平喘药	治疗
双侧跟膝腱	身体部位
鼻部CT	检查和检验
破伤风免疫球蛋白	治疗
外伤	疾病和诊断
前额部	身体部位
心前各瓣膜	身体部位
左侧膝部	身体部位
胸廓两侧	身体部位
输尿管、肾脏CT	检查和检验
左侧输尿管腹段	身体部位
近端输尿管	身体部位
左侧肾盂	身体部位
肾盏	身体部位
凝血	检查和检验
免疫	检查和检验
生化	检查和检验
肺病	疾病和诊断
枕顶部	身体部位
右侧颞顶部颅骨	身体部位
薄层硬膜	身体部位
右侧枕骨	身体部位
右侧小脑	身体部位
枕部	身体部位
顶部	身体部位
右侧顶部硬膜下血肿	疾病和诊断
头皮下血肿	疾病和诊断
右侧枕部	身体部位
枕骨骨	身体部位
腰1-5椎体棘突	身体部位
椎旁软组织	身体部位
右侧腰骶部	身体部位
右侧颞顶部	身体部位
支气管扩张症	疾病和诊断
脑瘤病	疾病和诊断
止咳祛痰药物	治疗
精神病	疾病和诊断
右侧踝部	身体部位
踝部	身体部位
左侧肩关节CT	检查和检验
右踝关节DR	检查和检验
皮肤裂伤	疾病和诊断
左侧耳屏	身体部位
左侧颞部	身体部位
左侧肩关节	身体部位
右侧腰3-4椎	身体部位
右侧踝关节	身体部位
右踝关节DR片	检查和检验
慢性萎缩性胃炎	疾病和诊断
双侧膝关节置换术	治疗
硝酸异山梨酯片	治疗
肺动脉	身体部位
主动脉壁	身体部位
冠状动脉走行区	身体部位
头孢类抗炎药物	治疗
右手皮肤软组织感染	疾病和诊断
右手手背	身体部位
皮肤表面	身体部位
左臀部	身体部位
盆骨平片	检查和检验
左侧基底节区	身体部位
左侧基底节区脑梗塞	疾病和诊断
头颅右顶部	身体部位
右髋部局部软组织	身体部位
腹部查体	检查和检验
盆骨正位片	检查和检验
流感	疾病和诊断
风疹	疾病和诊断
结核	疾病和诊断
人工流产	治疗
胎心音	检查和检验
胎方位	检查和检验
骨盆外测量	检查和检验
胎儿双顶径	检查和检验
股骨长	检查和检验
宫体后壁胎盘	身体部位
羊水AFI	检查和检验
左侧头面部	身体部位
皮肤粘膜	身体部位
左侧面部皮肤组织	身体部位
左侧第2、3、4肋	身体部位
头颅、胸部CT	检查和检验
结节性甲状腺肿	疾病和诊断
双侧颈部	身体部位
下淋巴结	身体部位
甲状双侧叶内	身体部位
胸部软组织伤	疾病和诊断
左侧胸背部第2-6肋间	身体部位
胸部正位+左斜位片	检查和检验
胸部CT、肋骨三维重建	检查和检验
左侧2、5、6、7肋骨	身体部位
左肩关节正位片	检查和检验
高血压性心脏病	疾病和诊断
口服药物	治疗
尿常规检查	检查和检验
彩超检查	检查和检验
左输尿管	身体部位
潜血	检查和检验
头外伤神经反应	疾病和诊断
皮肤软组织	身体部位
胸廓对称	身体部位
尿道肉阜	疾病和诊断
盗汗	身体部位
尿道粘膜	身体部位
截石位12点处	身体部位
左下肢前外侧	身体部位
小腿外侧	身体部位
左足大踇趾	身体部位
腰椎核磁	检查和检验
腰椎管狭窄	疾病和诊断
腰椎前区	身体部位
腰椎椎体	身体部位
左下肢小腿外侧皮肤	身体部位
踝部皮肤	身体部位
左足踇趾皮肤	身体部位
末梢血	身体部位
腰3-4、4-5间隙水平双侧椎间孔	身体部位
腰4-5、腰5骶1间隙水平椎管	身体部位
肛门、外生殖器	身体部位
左腹股沟斜疝	疾病和诊断
左腹股沟部	身体部位
双侧腹股沟彩超	检查和检验
左侧下腹部腹股沟区	身体部位
疝气	疾病和诊断
右侧腹股沟区	身体部位
髌骨切开复位内固定术	治疗
5个月	身体部位
双侧甲状腺肿	疾病和诊断
双侧甲状腺结节	身体部位
左侧头顶部	身体部位
伤口边缘	身体部位
磺胺类药物	治疗
右膝DR片	检查和检验
右膝软组织损伤	疾病和诊断
黏膜	身体部位
直肠癌切除术	治疗
肠道	身体部位
淤血	症状和体征
胸部正侧位、肘关节、肩关节	检查和检验
肛诊	检查和检验
腰1-5椎	身体部位
肝胆脾胰双肾CT	检查和检验
心绞痛	疾病和诊断
抗感染、止咳化痰	治疗
右锁骨中线第Ⅵ肋间隙	身体部位
体健	身体部位
右下腹部	身体部位
泌尿系彩超	检查和检验
右侧输尿管上段	身体部位
左侧	身体部位
左侧颈部	身体部位
腰3-5椎	身体部位
L5-S1棘间	身体部位
椎旁双侧	身体部位
双侧梨状肌	身体部位
L3/4、L4/5椎间盘	身体部位
L5/S1椎间盘	身体部位
胆囊壁	检查和检验
脾、胰	身体部位
破伤风	治疗
抗毒素	治疗
头颅鼻骨CT	检查和检验
氨曲南	治疗
醒脑静对症	治疗
头面部软组织损伤	疾病和诊断
皮下组织	身体部位
右额顶部	身体部位
耳背部	身体部位
胸腹	身体部位
慢性浅表性胃炎	疾病和诊断
心因反应	疾病和诊断
两侧肩胛部	身体部位
颈椎片	检查和检验
腰椎正侧位片	检查和检验
腰部软组织损伤	疾病和诊断
左手拇指远节	身体部位
手指末节	身体部位
左手X光片	检查和检验
左手拇指末节	身体部位
左手拇指末节开放骨折	疾病和诊断
远节背侧	身体部位
青紫	症状和体征
拇指末节	身体部位
拇指末节外侧	身体部位
水平硬膜囊	身体部位
右肩、右髋关节X线拍片	检查和检验
头枕上方	身体部位
右肩关节CT	检查和检验
右颈部	身体部位
头胸腹CT	检查和检验
腰椎颈椎正侧位片	检查和检验
左膝正侧位片	检查和检验
左肩正侧位片	检查和检验
右面部	身体部位
右颧弓处	身体部位
左前胸	身体部位
氨茶碱	治疗
止咳	治疗
化痰	治疗
平喘	治疗
呕血	症状和体征
便血	症状和体征
不全性肠梗阻	疾病和诊断
稀便	身体部位
剖宫产手术	治疗
胸部正侧位片	检查和检验
双膝正侧位片	检查和检验
依那普利	治疗
左侧基底节区腔隙性脑梗死	疾病和诊断
脊柱各椎体	身体部位
右膝前皮肤	身体部位
左心室	身体部位
双侧胫骨髁间嵴	身体部位
髌骨	身体部位
右侧腹股沟	身体部位
皮下环	身体部位
内环口	身体部位
指尖	身体部位
椎体棘突	身体部位
局部皮肤	身体部位
溃破	症状和体征
臀部脓肿	疾病和诊断
右侧阴囊内	身体部位
右侧睾丸、附睾炎	疾病和诊断
前列腺电切术	治疗
输液	治疗
右侧急性附睾炎	疾病和诊断
右侧附睾头	身体部位
右手正斜位	检查和检验
右手中指末节指骨粗隆	身体部位
右手中指指骨粗隆骨折	疾病和诊断
左额顶部	身体部位
腰椎间盘	身体部位
多处软组织	身体部位
腰4-5、腰5-骶1左侧椎旁	身体部位
向左侧臀部	身体部位
双足趾及踝部	身体部位
头面目	身体部位
右侧胸锁乳突	身体部位
右手右肘	身体部位
头枕部	身体部位
双膝、右手背	身体部位
头颅、鼻骨、全腹部CT	检查和检验
左侧第7肋骨	身体部位
右手正斜位X光	检查和检验
右肘、双膝正侧位X光	检查和检验
下颌骨X光	检查和检验
右手背	身体部位
眼眶CT	检查和检验
右侧眼眶外软组织	身体部位
破伤风抗毒素	治疗
左眼眶皮肤软组织裂伤	疾病和诊断
左眉弓上方	身体部位
右眼下方	身体部位
左耳前方	身体部位
肺癌晚期	疾病和诊断
急性尿潴留	疾病和诊断
支气管镜	检查和检验
右肺上叶	身体部位
支气管镜活检	检查和检验
纵膈内	身体部位
右肺门	身体部位
右侧局部胸膜	身体部位
双颈部	身体部位
尼群地平	治疗
喹诺酮类药物	治疗
前列腺增生	疾病和诊断
CP	检查和检验
PSA检测	检查和检验
普乐安	治疗
双肾盂	身体部位
双输尿管	身体部位
膀胱结石	疾病和诊断
输卵管结扎术	治疗
胃炎	疾病和诊断
左肾盂	身体部位
右腹	身体部位
平脐	身体部位
左手环指开放伤	疾病和诊断
左环指开放伤残端包埋术	治疗
左手环指远端	身体部位
左手正斜位	检查和检验
左手无名指末节	身体部位
左侧腹股沟斜疝手术	治疗
左髋	身体部位
左髋X光片	检查和检验
左股骨颈骨质	身体部位
左股骨颈骨折	疾病和诊断
左髋外侧	身体部位
左髋关节	身体部位
左足背	身体部位
左股骨颈	身体部位
左髌骨	身体部位
左髌骨骨折术后骨性愈合	疾病和诊断
局部	身体部位
足趾关节	身体部位
左膝关节正侧位X光片	检查和检验
左侧髌骨	身体部位
混合痔	疾病和诊断
肛门胸膝位6点、12点	身体部位
肛门缘	身体部位
直肠镜	检查和检验
右颈部肿物手术	治疗
右侧股骨颈	身体部位
股骨颈	身体部位
右股骨颈骨折	疾病和诊断
右下肢皮肤	身体部位
余肢体肢	身体部位
右髋关节正位	检查和检验
右股骨颈	身体部位
膀胱炎	疾病和诊断
脑梗死后遗症	疾病和诊断
尿潴留	疾病和诊断
右锁骨中线第Ⅴ肋间	身体部位
膀胱造瘘术	治疗
CT肋骨三维重建	检查和检验
左侧第四肋骨	身体部位
左侧胸壁皮下	身体部位
肋骨骨折	疾病和诊断
左侧第4肋骨	身体部位
余双侧肋骨	身体部位
左侧胸腔内	身体部位
行尿常规检验	检查和检验
无痛血尿	疾病和诊断
右髋关节置换术	治疗
右肾上极	身体部位
膀胱三角区	身体部位
2型糖尿病	疾病和诊断
脑栓塞病	疾病和诊断
左髋关节全髋置换术	治疗
腰椎X光片	检查和检验
胸12椎体	身体部位
骨质疏松症	疾病和诊断
胸12椎体压缩骨折	疾病和诊断
胸12-腰4椎体	身体部位
支腿抬高实验	检查和检验
腰椎正侧位X光片	检查和检验
腰3-腰5	身体部位
背	身体部位
踇趾背	身体部位
右侧S1神经根	身体部位
碎石取石术	治疗
阴部	身体部位
排石颗粒	治疗
泌尿系CT	检查和检验
双肾结石合并肾积水	疾病和诊断
尿道前列腺激光汽化术	治疗
尿道膀胱癌激光汽化术	治疗
膀胱癌	疾病和诊断
自腹壁造瘘口	身体部位
拳	身体部位
胸部X光片	检查和检验
胸部外伤	疾病和诊断
右上腹部	身体部位
前胸	身体部位
后背	身体部位
伤口周围	身体部位
背部胸椎	身体部位
头颅及胸部上腹部 CT	检查和检验
顶枕部头皮下	身体部位
肝囊	身体部位
腰部及双下肢	身体部位
双侧胫腓骨	身体部位
双侧踝关节	身体部位
双足	身体部位
胸腹CT	检查和检验
胸腰椎三维重建	检查和检验
舌部右侧	身体部位
双侧胫腓骨、双侧踝关节正侧位	检查和检验
双足正斜位	检查和检验
头颅及腹部CT	检查和检验
左侧肱骨、尺桡骨正侧位	检查和检验
腰椎正侧位	检查和检验
骨盆正位	检查和检验
腰3-骶1间盘CT	检查和检验
椎间盘	身体部位
腰部及左上肢外伤	疾病和诊断
颈椎手术	治疗
宫颈楔形切除术	治疗
脐周部	身体部位
右下腹及脐下	身体部位
嗜酸粒细胞百分比	检查和检验
颠茄片	治疗
气滞胃痛颗粒	治疗
腰大肌试验	检查和检验
闭孔内肌	身体部位
甲肝	疾病和诊断
增效联磺	治疗
红霉素	治疗
双肾 输尿管 膀胱检查	检查和检验
血常规检查	检查和检验
瓣膜听诊区	身体部位
心脏彩超	检查和检验
左室	身体部位
主动脉瓣	检查和检验
三尖瓣	检查和检验
两上肺	身体部位
冠状动脉	身体部位
阴囊透光实验	检查和检验
左侧睾丸	身体部位
直肠	身体部位
结肠癌	疾病和诊断
门诊彩超	检查和检验
前列腺增生症	疾病和诊断
乙型肝炎	疾病和诊断
面	身体部位
双侧巴氏	身体部位
右侧输尿管壁	身体部位
腹股沟	身体部位
茴香桔核丸	治疗
阴囊脓肿	疾病和诊断
左侧上部	身体部位
包皮龟头炎	疾病和诊断
包皮过长	疾病和诊断
双侧睾丸、附睾	身体部位
左侧上肢	身体部位
左肩，左肱骨，左肘，左尺桡骨X线片	检查和检验
头部颈椎腰椎CT	检查和检验
颈椎腰椎	身体部位
左侧第5肋骨	身体部位
干湿性罗音	检查和检验
左侧顶部头皮	身体部位
左肘关节、左股骨、左膝关节正侧位片	检查和检验
胆	身体部位
左膝关节正侧位	身体部位
右膝关节正侧位	身体部位
左下颌	身体部位
右侧上颌窦炎	疾病和诊断
左大腿中下段截肢手术	治疗
胸部正位DR片	检查和检验
右胸部外伤	疾病和诊断
右侧胸壁腋前线内侧	身体部位
颧部	身体部位
上唇部	身体部位
双侧颧弓骨质	身体部位
双侧颧	身体部位
精液常规	检查和检验
J-HD	检查和检验
A+B	检查和检验
双侧精索静脉曲张	疾病和诊断
慢性前列腺炎	疾病和诊断
左侧腹股沟斜疝修补术	治疗
睾丸鞘膜积液	疾病和诊断
左侧腹股沟斜疝	疾病和诊断
肝胆胰脾彩超	检查和检验
脂肪肝	疾病和诊断
胆囊、脾、胰	身体部位
右腹股沟疝手术	治疗
上膀胱区	身体部位
腰大肌实验	检查和检验
闭孔内肌实验	检查和检验
附睾炎	疾病和诊断
滑膜炎手术	治疗
青、链霉素类药物	治疗
右膝关节DR	检查和检验
膝关节骨性关节炎	疾病和诊断
右膝关节骨性关节炎	疾病和诊断
肺源性心脏病	疾病和诊断
慢阻肺	疾病和诊断
颅神经查	检查和检验
胸部透视	检查和检验
腹部透视	检查和检验
左上腹	身体部位
消化道穿孔	疾病和诊断
周身皮肤粘膜	身体部位
上腹及脐周	身体部位
胸透	检查和检验
腹透	检查和检验
右隔下游	身体部位
右中腹	身体部位
心包积液	疾病和诊断
上消化道穿孔	疾病和诊断
右膝皮肤擦伤	疾病和诊断
头颅、颧弓、腹部CT及右膝DR片	检查和检验
周身皮肤、粘膜	身体部位
稍渗出	身体部位
头颅、颧弓、腹部CT	检查和检验
肝胆脾胰及双肾CT	检查和检验
双侧肋骨CT	检查和检验
全身多处软组织损伤	疾病和诊断
双侧眼眶	身体部位
右眼睑	身体部位
鼻根部	身体部位
上腹部彩超	检查和检验
上腹部软组织损伤	疾病和诊断
右前额部	身体部位
额部右侧	身体部位
右前额部、腹部软组织损伤	疾病和诊断
安乃近	治疗
右耳部	身体部位
左上唇	身体部位
颅脑CT	检查和检验
胸位正位片	检查和检验
肋骨三维检查	检查和检验
右肺挫伤	疾病和诊断
左肺索条	疾病和诊断
左肺上叶近纵隔旁透明影	疾病和诊断
右侧液气胸	疾病和诊断
右侧多发肋骨骨折	疾病和诊断
右侧胸背部皮下气肿	疾病和诊断
副脾	疾病和诊断
冠状动脉见钙化	疾病和诊断
胸部x片	检查和检验
右侧第9肋骨骨折	疾病和诊断
第10肋骨	身体部位
皮下气肿	疾病和诊断
肋骨骨折合并液气胸	疾病和诊断
左肺上叶近纵隔旁	身体部位
胸x片	检查和检验
第9肋骨	身体部位
双膝部正侧位	检查和检验
双侧膝关节	身体部位
头颞部	身体部位
第4、5掌指关节	身体部位
手指关节	身体部位
右肩关节正位片	检查和检验
右肘关节正位片	检查和检验
健骨药物	治疗
血红蛋	检查和检验
贫血	疾病和诊断
额突	身体部位
双侧基底节	身体部位
腰骶部	身体部位
抗炎	治疗
减清软组织水肿及改善骨质代谢药物	治疗
双鼻孔	身体部位
肺部	身体部位
促进骨折愈合、促进组织修复、降糖、降压、止痛药物	治疗
左上肢肩肘	身体部位
活血化瘀药物	治疗
营养脑细胞药物	治疗
软组织修复药物	治疗
脑细胞营养药物	治疗
止疼、营养脑神经、活血化瘀等药物	治疗
活血及对症药物	治疗
左胸	身体部位
营养脑神经、促进组织修复、止痛等对症药物	治疗
左侧输尿管结石碎石取石术	治疗
左肾结石，左输尿管结石碎石取石术	治疗
左肾造瘘管	身体部位
尿管	身体部位
左背部皮脂囊肿切除术	治疗
山莨菪碱	治疗
杜冷丁	治疗
黄体酮	治疗
左氧氟沙星	治疗
生理盐水	治疗
赖氨匹林	治疗
地塞米松	治疗
泌尿系感染合并SIRS	疾病和诊断
头孢替唑	治疗
头孢哌酮舒巴坦钠	治疗
替硝唑	治疗
三联抗生素	治疗
膀胱镜室	身体部位
左侧输尿管	身体部位
血管活性药物	治疗
体外碎石	治疗
止痛，促进骨质愈合等药物	治疗
鼻骨骨折复位手术	治疗
对症药物	治疗
双侧精索静脉	身体部位
在局麻下行包皮环切术	治疗
凝血四项	检查和检验
输血前八项	检查和检验
左侧胸腔闭式引流	治疗
左背部清创缝合	治疗
胸腔	身体部位
脓肿切开引流术	治疗
止痛药物	治疗
门诊血常规	检查和检验
头孢哌酮舒巴坦钠注射液	治疗
盐酸氨溴索注射液	治疗
蜜炼川贝枇杷膏	治疗
小儿热速清糖浆	治疗
布地奈德	治疗
沙丁胺醇	治疗
气道	身体部位
孟鲁司特钠咀嚼片	治疗
抗病毒口服液	治疗
小儿清咽颗粒	治疗
右手拇指屈拇肌腱狭窄性腱鞘炎切开松解术	治疗
抗生素药物	治疗
抗炎、营养脑神经、活血化瘀、止疼等药物	治疗
孢曲松	治疗
丘疹	症状和体征
周身	身体部位
胸部正位	身体部位
呼吸道	身体部位
头孢替唑注射液	治疗
复方甘草酸单铵S注射液	治疗
氯雷他定片	治疗
炉甘石洗剂	治疗
中小水泡音	检查和检验
头孢哌酮	治疗
炎琥宁	治疗
脑电图	检查和检验
维生素C	治疗
地西泮	治疗
盐酸丙卡特罗	治疗
肺宁颗粒	治疗
蓝芩口服液	治疗
葡萄糖	检查和检验
盐酸氨溴索	治疗
清宣止咳	治疗
肺力咳合剂	治疗
布地奈德雾	治疗
氨溴特罗	治疗
鲜竹沥口服液	治疗
骨营养药物及止痛药物	治疗
中等量喘鸣音	检查和检验
毛细支气管	身体部位
氨溴索	治疗
复方鲜竹沥	治疗
孟鲁斯特咀嚼片	治疗
感冒清热颗粒	治疗
八正合剂	治疗
头孢替唑钠	治疗
炎琥宁抗感染	治疗
复方鲜竹沥液	治疗
小儿肺热咳喘颗粒	治疗
阿奇霉素注射液	治疗
吉他霉素	治疗
氨溴特罗口服液	治疗
鲨甘醇片	治疗
维生素B4片	治疗
肥大	症状和体征
血红蛋白量	检查和检验
头孢曲松钠注射液	治疗
蒲地蓝口服液	治疗
奥司他韦	治疗
金莲花	治疗
头孢呋辛	治疗
左上肢肿物切除术	治疗
抗感染药物	治疗
多发淋巴结	疾病和诊断
复方鲜竹沥止	治疗
孟鲁斯特	治疗
盐酸氨溴索口服液	治疗
叩诊清音	检查和检验
肝脏彩超	检查和检验
轻度脂肪肝	疾病和诊断
克林霉素	治疗
氨曲南注射液	治疗
连花清瘟胶囊	治疗
清咽利喉颗粒	治疗
舌下及颈部淋巴结	身体部位
喜炎平液	治疗
右下腹肠	身体部位
喜炎平	治疗
苯丙哌林	治疗
鼾鸣音	检查和检验
川贝枇杷膏	治疗
喘鸣音	检查和检验
盐酸丙卡特罗口服液	治疗
右膝关节表面置换术	治疗
左膝关节表面置换术	治疗
桑菊感冒清热颗粒	治疗
养阴清肺	治疗
头孢唑啉钠注射液	治疗
布洛芬混悬液	治疗
苯丙哌林口服液	治疗
丙卡特罗	治疗
盐酸苯丙哌林口服液	治疗
营养脑神经、止疼、活血化瘀等药物	治疗
中细湿性啰音	检查和检验
奥司他韦颗粒	治疗
上呼吸道	身体部位
眼结膜	身体部位
躯干及臀部	身体部位
川崎病	疾病和诊断
清宣止咳颗粒	治疗
双手，双足	身体部位
小儿清咽	治疗
肝功	检查和检验
电解质	检查和检验
调节胃肠道药物	治疗
止咳药物	治疗
软组织修复、止血、营养脑神经及口服药物	治疗
头孢哌酮注射液	治疗
小儿百部止咳糖 浆	治疗
头孢哌酮钠注射液	治疗
川贝清肺	治疗
利巴韦林雾化	治疗
盐酸氨溴索葡萄糖注射液	治疗
双手	身体部位
炎琥宁注射液	治疗
地西泮片	治疗
阿奇霉素干混悬剂	治疗
蒲公英	治疗
上额部	身体部位
鼻窦CT	检查和检验
清热解毒口服液	治疗
鼻渊通窍	治疗
川贝蜜炼	治疗
阿司匹林	治疗
阿托伐他汀	治疗
奥扎格雷	治疗
依达拉奉	治疗
肾功能	检查和检验
阿司匹林肠溶片	治疗
疏血通	治疗
奥扎格雷钠	治疗
肝功2	检查和检验
风湿三项	检查和检验
0.9%氯化钠	治疗
鹿瓜多肽	治疗
银杏达莫注射液	治疗
脑蛋白水解物	治疗
泮托拉唑抑酸	治疗
螺内酯	治疗
呋塞米	治疗
左肘关节松懈术	治疗
左桡骨远端内固定物取出术	治疗
拜阿司匹林	治疗
丹红注射液	治疗
泮托拉唑	治疗
血、尿常规	检查和检验
20%甘露醇	治疗
地塞米松注射液	治疗
0.9%氯化钠注射液	治疗
甲钴胺	治疗
大活络丸	治疗
胸腔穿刺术	治疗
前列腺彩超	检查和检验
依那普利降压	治疗
疏血通注射液	治疗
加地塞米松注射液	治疗
用骨肽	治疗
甲钴胺注射液	治疗
湿罗音	检查和检验
司匹林	治疗
奥扎格雷钠降纤	治疗
颅内	身体部位
开放性颅脑损伤清创缝合术	治疗
营养脑神经药物	治疗
物硝苯地平缓释片	治疗
血脂康胶囊	治疗
甘露醇	治疗
甲钴胺片	治疗
麝香壮骨膏	治疗
美托洛尔	治疗
床旁心电	检查和检验
颈椎双斜位及侧位	身体部位
长春西汀注射液	治疗
头颅TCD	检查和检验
辛伐他汀	治疗
肾功	检查和检验
胞磷胆碱注射液	治疗
5%葡萄糖注射液	治疗
脑血管	身体部位
牛黄清心丸	治疗
中成药物大活络丸	治疗
颈复康颗粒	治疗
活血通络	治疗
普罗帕酮	治疗
颈动脉彩超	检查和检验
银杏达莫	治疗
非那雄胺	治疗
腹部及妇科彩超	检查和检验
地塞米松10mg	治疗
质子泵拮抗剂	治疗
泌尿系增强CT	检查和检验
右肾包膜	身体部位
鹿瓜多肽注射液	治疗
降胆固醇药物	治疗
麻仁滋脾丸	治疗
注射用骨肽	治疗
颈椎间盘	身体部位
脊髓	身体部位
椎间管	身体部位
颈椎间	身体部位
罂粟碱注射液	治疗
脑血管药物	治疗
降血糖药物	治疗
二甲双胍片	治疗
降血压药物	治疗
坎地沙坦酯片	治疗
辛伐他汀胶囊	治疗
活血止痛药物	治疗
调节血脂药物	治疗
肝肾功能	检查和检验
止痛及前列腺增生	治疗
中药	治疗
氯化钠	治疗
头、颈部血管	身体部位
中成药大活络丸	治疗
盐酸左氧氟沙星胶囊	治疗
知柏地黄丸	治疗
中药汤剂	治疗
知柏地黄汤加减方	治疗
心肌	身体部位
改善循环药物	治疗
总胆固醇	检查和检验
颈椎侧斜位X光	检查和检验
稳心颗粒	治疗
尿糖	检查和检验
外股骨头疾患	疾病和诊断
双髋关节MRI	检查和检验
左侧闭孔外肌	身体部位
耻骨肌	身体部位
腹膜	身体部位
抗感染、抑酸，解痉等药物	治疗
剖腹探查术	治疗
右卵巢	身体部位
左侧卵巢	身体部位
肠管	身体部位
双侧卵巢囊肿剥除术	治疗
双侧卵巢	身体部位
子宫内膜	身体部位
子宫下段剖宫产术	治疗
左枕前	身体部位
胎盘胎膜	身体部位
前列腺激光汽化术	治疗
头部裂口清创缝合术	治疗
颈椎DR片	检查和检验
左肾结石碎石取石术	治疗
胃疼	症状和体征
上消化道造影	检查和检验
果胶铋	治疗
脑细胞、软组织修复药物	治疗
双侧颈总动脉	身体部位
右侧颈内动脉	身体部位
右侧椎动脉	身体部位
左侧颈总动脉	身体部位
双侧颈外动脉颅外段	身体部位
左侧椎动脉	身体部位
糖化血红蛋白	检查和检验
肌酐	检查和检验
空腹葡萄糖	检查和检验
阿托伐他汀钙	治疗
舒血宁	治疗
止血、改善脑细胞代谢药物	治疗
降低颅内压	治疗
左锁骨远端骨折切开复位锁定钩钛板内固定术	治疗
止疼、活血化瘀、抗炎	治疗
左额颞顶部	身体部位
右侧小脑角区	身体部位
脑膜瘤	疾病和诊断
坎地沙坦	治疗
硝酸甘油	治疗
阿卡波糖	治疗
脑细胞代谢药物	治疗
右膝MRI	检查和检验
右膝后交叉韧带	身体部位
腓侧副韧带	身体部位
关节腔	身体部位
韧带重建手术	治疗
多索茶碱	治疗
塞米松注射液	治疗
大活络丹	治疗
腰痛宁	治疗
鼻部软组织	身体部位
面部软组织	身体部位
左侧膝部软组织	身体部位
酸碱度	检查和检验
阿托伐他丁	治疗
罂粟碱	治疗
输尿管镜左侧输尿管结石碎石取石术	治疗
抑酸、化痰补液	治疗
高渗盐	治疗
低钠低氯血症	疾病和诊断
头颅MRI	检查和检验
颈椎MRI	检查和检验
咳脓痰	症状和体征
慢性肺源性心脏病	疾病和诊断
茶碱缓释片	治疗
硝酸甘油注射液	治疗
盐酸氨溴索葡糖糖注射液	治疗
胃黏膜	身体部位
尿酸	检查和检验
抗感染、止咳化痰、舒张气道等药物	治疗
软组织药物	治疗
抗生素口服药物	治疗
消化系超声	检查和检验
心脏超声	检查和检验
左心	检查和检验
颈部血管超声	检查和检验
双侧颈动脉	身体部位
双侧椎动脉	身体部位
胃粘膜	身体部位
右手掌脓肿切开引流术	治疗
氨磺必利	治疗
氯氮平片	治疗
苯海索	治疗
混合痔切除术	治疗
脂肪瘤切除术	治疗
抗炎、营养脑神经	治疗
阿氏评分	检查和检验
营养脑神经、促进组织修复药物	治疗
心肺腹	身体部位
前列腺液常规	检查和检验
卵磷脂	检查和检验
前列腺慢性炎症	疾病和诊断
特拉唑嗪	治疗
前列康舒胶囊	治疗
右侧甲状腺大部切除术	治疗
（右）状腺	身体部位
左胸背部软组织	身体部位
左肘部皮肤	身体部位
促进骨折愈合、促进组织修复、止痛等对症药物	治疗
左肩关节软组织	身体部位
促进组织修复、止痛等对症药物	治疗
盐酸左氧氟沙星氯化钠	治疗
左输尿管结石体外冲击波碎石术	治疗
尿道肉阜切除术	治疗
椎管切开减压椎弓钉内固定cage植骨融合内固定术	治疗
营养神经、抗骨质疏松药物	治疗
腰麻下行阑尾切除术	治疗
切口清创缝合术	治疗
谷丙转氨酶	检查和检验
左侧腹股沟充填式疝无张力修补术	治疗
抗炎、补液	治疗
甲功五项	检查和检验
甲状腺大部切除术	治疗
止疼、活血化瘀、营养脑神经等药物	治疗
肠粘连	疾病和诊断
肠道肿瘤	疾病和诊断
抗炎、止疼、活血化瘀、促进软组织愈合等药物	治疗
长 春西汀	治疗
止疼、健骨、营养脑神经等药物	治疗
TCD	检查和检验
脑动脉	身体部位
改善循环、改善脑代谢、抗凝等药物	治疗
故脑梗死后遗症	疾病和诊断
双肺支气管	身体部位
甘草片	治疗
密炼川贝枇杷膏	治疗
氨茶碱、茶碱缓释片	治疗
干湿性啰 音	检查和检验
固定湿罗音	检查和检验
慢性肺源性心脏病-心肺功能失代偿期	疾病和诊断
钾	检查和检验
电解质紊乱-低钾血症	疾病和诊断
氨溴索注射液	治疗
氢氯噻嗪	治疗
氯化钾口服液	治疗
中药泻心汤	治疗
注射用奥美拉唑	治疗
脑神经	身体部位
心音反应	疾病和诊断
混合型高脂血症	疾病和诊断
阿托伐他汀钙片	治疗
肩胛部	身体部位
颈 椎	身体部位
颈椎正侧位片	检查和检验
舒血宁注射液	治疗
消炎利胆片	治疗
左手拇指清创骨折复位克氏针内固定术术程顺利	治疗
抗炎、扩血管	治疗
右肩部三角肌	身体部位
右肩关节腔	身体部位
促进软组织修复药物	治疗
止痛、活血化瘀药物	治疗
钠	检查和检验
氯	检查和检验
活血化瘀、抗炎、营养神经药物	治疗
右侧腹股沟斜疝无张力疝修补	治疗
抗炎药	治疗
臀部脓肿切开引流术	治疗
包皮环切术	治疗
头孢西丁钠	治疗
50%硫酸镁	治疗
营养脑神经及修复软组织药物	治疗
营养神经药物及修复软组织药物	治疗
软组织修复药物及营养脑细胞药物	治疗
应用止疼、抗炎、活血化瘀、营养脑神经等药物	治疗
左颈部淋巴结	身体部位
右锁骨上淋巴结	身体部位
胸椎	身体部位
抗生素、营养支持、止痛及对症药物	治疗
膀胱肿瘤汽化术	治疗
表柔比星	治疗
膀胱结石气压弹道碎石术	治疗
体位冲击波碎石	治疗
注射用头孢替唑钠	治疗
胃胀	症状和体征
马来酸曲美布汀胶囊	治疗
体外冲击波碎石	治疗
降压	治疗
肾上腺	身体部位
抗炎及修复软组织药物	治疗
左侧人工股骨头置换术	治疗
蛛网膜下腔	身体部位
左髌骨骨折内固定物取出术	治疗
抗炎补液药物	治疗
环形混合痔切除术	治疗
肛门直肠脱垂术	治疗
直肠前突修补术	治疗
右股骨颈骨折髋关节股骨头表面置换术	治疗
抗凝	治疗
尿道膀胱结石碎石取石术	治疗
泌尿系B超	检查和检验
祛痰药物	治疗
膀胱腹壁瘘修补术	治疗
止疼、活血化瘀、营养神经等药物	治疗
抗生素、降糖、治疗冠心病等药物	治疗
抗骨质疏松药物	治疗
核磁	检查和检验
腰围	身体部位
活血止痛药物腰痛宁	治疗
洛索洛芬钠	治疗
缓解肌肉紧张药物	治疗
复方氯唑沙宗片	治疗
右肾结石碎石取石术	治疗
膀胱镜	检查和检验
灭菌用水	治疗
软组织修复	治疗
肋骨CT 三维重建	检查和检验
胸椎核磁	检查和检验
局灶性血管脂肪瘤	疾病和诊断
营养脑细胞及修复软组织药物	治疗
修复软组织药物	治疗
硬膜外	身体部位
坦索罗辛胶囊	治疗
右侧睾丸鞘膜积液	疾病和诊断
肺气肿	疾病和诊断
前列癃闭通片	治疗
非那雄胺片	治疗
盐酸苯海索片	治疗
利培酮片	治疗
劳拉西泮片	治疗
白蛋白	检查和检验
复方氨基酸注射液	治疗
维生素C注射	治疗
胰岛素注射液	治疗
瑞格列奈片	治疗
左侧阴囊脓肿切开引流术	治疗
头孢呋新酯	治疗
活血化瘀、抗炎、止疼药物	治疗
右侧肾窦	身体部位
右肾窦	身体部位
血糖检验	检查和检验
降糖药物	治疗
挫伤处碘伏	治疗
右侧胸	身体部位
双侧精索静脉高位结扎术	治疗
右侧睾丸鞘膜切除术	治疗
左侧精索囊肿切除术	治疗
左侧腹股沟斜疝无张力修补术	治疗
左腹股沟斜疝无张力修补术	治疗
镇痛镇静药物	治疗
吗啡缓释片	治疗
阑尾慢性炎	疾病和诊断
急性化脓性炎	疾病和诊断
右侧输尿管结石碎石取石术	治疗
改善骨质代谢药物	治疗
调节血压药物	治疗
窦性心动	检查和检验
房性	检查和检验
脾胰	检查和检验
二尖瓣	检查和检验
总蛋白	检查和检验
甘油三脂	检查和检验
尿素	检查和检验
哆嗦茶碱	治疗
立位胸片	检查和检验
躁动	症状和体征
健骨、止疼、活血化瘀等药物	治疗
传染病八项	检查和检验
活血化瘀	治疗
抑酸	治疗
抗炎及祛痰药物	治疗
肋骨CT	检查和检验
右侧第9,10,11肋骨	身体部位
促进营养脑神经、组织修复、止痛等对症药物	治疗
